Aruba=Oranjestad
United Arab Emirates=Abu Dhabi
Afghanistan=Kabul
Algeria=Algiers
Azerbaijan=Baku (Baki, Baky)
Albania=Tirana (Tirane)
Armenia=Yerevan
Andorra=Andorra la Vella
Angola=Luanda
American Samoa=Pago Pago
Argentina=Buenos Aires
Australia=Canberra
Austria=Vienna
Anguilla=The Valley
Akrotiri=Episkopi Cantonment (base administrative center for Akrotiri and Dhekelia)
Bahrain=Manama
Barbados=Bridgetown
Botswana=Gaborone
Bermuda=Hamilton
Belgium=Brussels
Bahamas, The=Nassau
Bangladesh=Dhaka
Belize=Belmopan
Bosnia and Herzegovina=Sarajevo
Bolivia=La Paz (administrative capital)
Burma=Rangoon (Yangon)
Benin=Porto-Novo (official capital)
Belarus=Minsk
Solomon Islands=Honiara
Brazil=Brasilia
Bhutan=Thimphu
Bulgaria=Sofia
Brunei=Bandar Seri Begawan
Burundi=Bujumbura
Canada=Ottawa
Cambodia=Phnom Penh
Curacao=Willemstad
Sri Lanka=Colombo
Congo, Republic of the=Brazzaville
Congo, Democratic Republic of the=Kinshasa
China=Beijing
Chile=Santiago
Cayman Islands=George Town (on Grand Cayman)
Cocos (Keeling) Islands=West Island
Cameroon=Yaounde
Comoros=Moroni
Colombia=Bogota
Northern Mariana Islands=Saipan
Costa Rica=San Jose
Central African Republic=Bangui
Cuba=Havana
Cabo Verde=Praia
Cook Islands=Avarua
Denmark=Copenhagen
Djibouti=Djibouti
Dominica=Roseau
Dominican Republic=Santo Domingo
Ecuador=Quito
European Union=Brussels (Belgium), Strasbourg (France), Luxembourg
Egypt=Cairo
Ireland=Dublin
Equatorial Guinea=Malabo
Estonia=Tallinn
Eritrea=Asmara (Asmera)
El Salvador=San Salvador
Ethiopia=Addis Ababa
Czech Republic=Prague
Finland=Helsinki
Fiji=Suva (on Viti Levu)
Falkland Islands (Islas Malvinas)=Stanley
Micronesia, Federated States of=Palikir
Faroe Islands=Torshavn
French Polynesia=Papeete (located on Tahiti)
France=Paris
Gambia, The=Banjul
Gabon=Libreville
Georgia=Tbilisi
Ghana=Accra
Gibraltar=Gibraltar
Guernsey=Saint Peter Port
Greenland=Nuuk (Godthab)
Germany=Berlin
Guam=Hagatna (Agana)
Greece=Athens
Guatemala=Guatemala City
Guinea=Conakry
Guyana=Georgetown
Haiti=Port-au-Prince
Honduras=Tegucigalpa
Croatia=Zagreb
Hungary=Budapest
Iceland=Reykjavik
Indonesia=Jakarta
Isle of Man=Douglas
India=New Delhi
Iran=Tehran
Israel=Jerusalem
Italy=Rome
=Yamoussoukro
Iraq=Baghdad
Japan=Tokyo
Jersey=Saint Helier
Jamaica=Kingston
Jordan=Amman
Kenya=Nairobi
Kyrgyzstan=Bishkek
Korea, North=Pyongyang
Kiribati=Tarawa
Korea, South=Seoul
Christmas Island=The Settlement
Kuwait=Kuwait City
Kosovo=Pristina (Prishtine, Prishtina)
Kazakhstan=Astana
Laos=Vientiane (Viangchan)
Lebanon=Beirut
Latvia=Riga
Lithuania=Vilnius
Liberia=Monrovia
Slovakia=Bratislava
Liechtenstein=Vaduz
Lesotho=Maseru
Luxembourg=Luxembourg
Libya=Tripoli (Tarabulus)
Madagascar=Antananarivo
Moldova=Chisinau in Romanian (Kishinev in Russian)
Mongolia=Ulaanbaatar
Montserrat=Plymouth
Malawi=Lilongwe
Macedonia=Skopje
Mali=Bamako
Monaco=Monaco
Morocco=Rabat
Mauritius=Port Louis
Mauritania=Nouakchott
Malta=Valletta
Oman=Muscat
Maldives=Male
Mexico=Mexico City (Distrito Federal)
Malaysia=Kuala Lumpur
Mozambique=Maputo
New Caledonia=Noumea
Niue=Alofi
Norfolk Island=Kingston
Niger=Niamey
Vanuatu=Port-Vila (on Efate)
Nigeria=Abuja
Netherlands=Amsterdam
Norway=Oslo
Nepal=Kathmandu
Suriname=Paramaribo
Nicaragua=Managua
New Zealand=Wellington
South Sudan=Juba
Paraguay=Asuncion
Pitcairn Islands=Adamstown
Peru=Lima
Pakistan=Islamabad
Poland=Warsaw
Panama=Panama City
Portugal=Lisbon
Papua New Guinea=Port Moresby
Palau=Melekeok
Guinea-Bissau=Bissau
Qatar=Doha
Serbia=Belgrade (Beograd)
Marshall Islands=Majuro
Saint Martin=Marigot
Romania=Bucharest
Philippines=Manila
Puerto Rico=San Juan
Russia=Moscow
Rwanda=Kigali
Saudi Arabia=Riyadh
Saint Pierre and Miquelon=Saint-Pierre
Saint Kitts and Nevis=Basseterre
Seychelles=Victoria
South Africa=Pretoria (administrative capital)
Senegal=Dakar
Saint Helena, Ascension, and Tristan da Cunha=Jamestown
Slovenia=Ljubljana
Sint Maarten=Philipsburg
Sierra Leone=Freetown
San Marino=San Marino
Singapore=Singapore
Somalia=Mogadishu
Spain=Madrid
Saint Lucia=Castries
Sudan=Khartoum
Svalbard=Longyearbyen
Sweden=Stockholm
Syria=Damascus
Switzerland=Bern
Saint Barthelemy=Gustavia
Trinidad and Tobago=Port of Spain
Thailand=Bangkok
Tajikistan=Dushanbe
Turks and Caicos Islands=Grand Turk (Cockburn Town)
Togo=Lome
Sao Tome and Principe=Sao Tome
Tunisia=Tunis
Timor-Leste=Dili
Turkey=Ankara
Tuvalu=Funafuti
Taiwan=Taipei
Turkmenistan=Ashgabat (Ashkhabad)
Tanzania=Dar es Salaam
Uganda=Kampala
United Kingdom=London
Ukraine=Kyiv (Kiev)
United States=Washington, DC
Burkina Faso=Ouagadougou
Uruguay=Montevideo
Uzbekistan=Tashkent (Toshkent)
Saint Vincent and the Grenadines=Kingstown
Venezuela=Caracas
British Virgin Islands=Road Town
Vietnam=Hanoi (Ha Noi)
Virgin Islands=Charlotte Amalie
Holy See (Vatican City)=Vatican City
Namibia=Windhoek
Wallis and Futuna=Mata-Utu (on Ile Uvea)
Samoa=Apia
Swaziland=Mbabane
Yemen=Sanaa
Zambia=Lusaka
Zimbabwe=Harare
